XXXTXXXXXXXXXXXXXXXXXXXXXXXXXXXXXXXXXXXXXXXXXXXXXXXXXXXXXXXXXXXXXXXXXXXXX
XXLDRXXXXXXXXXXXXXXXXXXXXXXXXXXXXXXXXXXXXXXXXXXXXXXXXXXXXXXXXXXXXXXXXXXXX
XLDDDRXXXXXXXXXXXXXXXXXXXXXXXLTRXXXXXXXXXXXXXXXXXXXXXXXXXXXXXXXXXXXXXXXXX
TDDDDDTTTTTTTTTTTRXXXXLTTTTTTDDDTTTTTTRXXXXXXXXXXXXXXXXXXXXXXXXLTTTTTTTTT
DDDDDDDDDDDDDDDDDDTTTTDDDDDDDDDDDDDDDDDTTTTTTTTTTTTTTTTTTTTTTTTDDDDDDDDDD
DDDDDDDDDDDDDDDDDDDDDDDDDDDDDDDDDDDDDDDDDDDDDDDDDDDDDDDDDDDDDDDDDDDDDDDDD
DDDDDDDDDDDDDDDDDDDDDDDDDDDDDDDDDDDDDDDDDDDDDDDDDDDDDDDDDDDDDDDDDDDDDDDDD